1111111111
1011001111
1000100001
1011001101
1001101101
1001001001
101000001
1100020001
1000000001
1111111111
