1111111111
1011001111
1000000001
1000000001
1000000001
1000000001
1000000001
1000000001
1000200001
1111111111
