1111111111
1011001111
1000100001
1011001101
1001001101
1001001001
1001000001
1000020001
1000000001
1111111111
